039875261786241395021639874678524913352917486194386752265498137847153629913762540
009802010602710500070000068800305027020080090910207006150000040004021803060403900
009301200017200040600040075100080067005907800730060002380010009050008620004605300
706000500028034100010702080860900020000316000030007095050803010004620850002000907
903000400041028900050401030470200090000819000080005026060103070008970650007000203
700090001060070030400203007607000205001507400809000603200106009030080050500040002
201300500030800401050109060006085700380000024007940600040508090903001040008006207
504000700026098300070504090950100070000327000060009014030401060005960420008000109
160008075870026009000030800050009210006107400018200050001070000300640081490800027
901700500060500302020409080006084700810000054009120600070203060605007010004001809
102000800078019600090302050320500060000276000050008074080701030003840910004000502
106000400049061800050304020620100030000435000070009018090506080003970240008000105
401062005050400006020900080800000030004205900070000004080003020900008010300570600
401000800062049100080603040940300020000761000010002087070506010005980430006000702
902000400035094100040108090320600040000283000050001037080406010001830760007000302
543001009097400360600080700000098140000503000028760000004050003036007510200900487
820000047007100500500403000600020380000050000098030004000807003001006200340000018
000008245301050090500094300070640003604000902800072010009120007050030604283400000
300010054240600080008903100003080790900501003067020400006802500030004027410090006
308000700076053200050709030680300020000142000020008057030904010009820640004000809
108000900064017200070602030410200060000531000050006098030809050002470310005000807
206000700094052800010907020950200060000415000040006018080304070005870140003000906
000410006309060100000008007031240700008000500002035490100700000005090803700056000
041390000070001864020708003039000708100060009407000650200109080715200040000054210
009203800065700030200040091700060054006407100120030007930080005080001640001905200
029130000060004931080607005048000503900080004605000870200708010713900040000061250
602000700035096800080304050310400060000637000020008073060102090004850310009000204
502000300063017900080902040310400060000178000020005079040601020006290450008000601
200080003090060020600305007902000801004807300706000409800601004050070010400030005
730000016000105000802000304004601500080000070003209600401000702000407000290000068
071420000020001534060508001047000209600050003302000670800602090795300060000085410
006001200050240030209800104100050420080104060065090008508006309070023080003700600
508000300079048600020503040180600070000482000060007089030105060006890750004000201
800090027450600010002803900008050140500106008096080700004507300030001082260040009
190000037002700400300806000600050180000060000021070004000902001009003800840000052
100040003080030070200906008407000809002805400608000301700201005030090010500060004
009604100035700090600020058100090024002506300850030006910070003040003810006901700
809000400051078300020304090790800030000745000010009048070403010005680270003000904
053000610000102000910070038006308500500000003008209700670040021000603000025000840
046930000030001659090802003067000108400010005308000960600203090951700040000049570
120003009000089060695100080003010906800402005904070100040008617060250000700600032
602000900049031800010602030150300020000567000070004083060408050005920310007000608
040205060300000002001609800020183090080000010050794030002306700500000006090801040
509000100068095400040807060730600090000924000020008054080209010007510230005000906
307000200059012800020308050570200010000867000040005079090603040001520960002000503
105000200036091500040205060650300020000649000090002078070403010004150380002000704
041000980000609000390040065006302100800000002007506800960010047000204000084000310
300000006400903002008126500030709020040000080080501070006315200700204008100000009
810005006000071040475300080004010805100509004906020300060004731020690000700100062
156008003023500980400070600000029340000807000081650000002090001034005870900700432
740008002000093080368700050001080503400106009902040700030009175010430000800200064
580000403069300072200940050000801620001020700052406000030069008140005930908000061
509000300036057200080209040690100020000983000070004051050708060001560730008000502
206000100034076500050208030870400060000635000020009041090503020007810450002000803
508000100013086900090401060150800030000675000020004087070509040006130750005000608
608000400042057300090104050580300020000978000030002018020706090001820730009000102
150004008000036020324700090002040509900205003507010800010002367060870000700400081
900020068840700020006903400005030780700206003014050600002408500080005049450070001
740008003000069070632100080007080201900607005501040300010005934070490000200800056
500000009018000540000563000005917400720000091001286300000359000034000210800000006
400702008090604010008000300002806500500000009007109600005000700060508090300201004
620003009000015020971600050009060205300107008104020900040009561010430000200800037
005802070307940100020000056600504013030090040280701005790000080003017509050409200
008102600096400010300080092900060043003809700760050008150040009070005260009701500
608000200023047800070205040910700060000321000030009025090106080006530970001000406
060372080700000003005000400630508041000030000910607032002000800100000007070491050
692001007018200690500070200000039840000508000049160000003010004056007930200400586
307000600064091500020807030950100040000679000070002063080204050005730890003000701
090230000010600058008700600000000582600040003153000000001006400240005070000027090
005904000020000410380007200701300090000080000090005103009400035067000040000708600
007108040405920800010000062600507031090040070750306008380000020002081703070204900
307900600060100905090402010004086200970000058008730400080604030501007090003005107
230570000006210004500009320809005070060901050010600203048700005700056800000094031
200009760070010980300500004000020078007000400540030000400007009061040050028300006
280000509015200064900840030000508740009030200057106000030061008790004620601000057
000270146000060093009000500400500010003000200070003008008000700960020000152084000
700000001046000870000579000007632100310000068004198500000264000063000980200000005
970004056310056009000070300060003870004709200031500090003040000800290031490100062
100040023320600080008503400003070610700209004082030500009407100040005098850060007
000240009907030500000005003091320800006000700008056910200100000005090604700083000
730002046160058009000070100040009560008403900027500010002060000500930084810200097
150003006000089050639100070004020905300806001701030600010008524080450000500900067
030051000450080309007400850086009035000306000720500490048002500605030012000960040
130007009000032010247800030008040203400609001506080400080006942050910000900300056
837009004041200970900010600000053210000904000056870000002040001069005740500700368
084000360000405000920030018006208900200000007003901500590040031000607000012000870
800000004700805006005491800070104080060000020010703060009346100300209005100000002
216005009084900720900010500000079310000604000037120000002090006095006170300800942
005209600037600090900050087400060059009302700370010006280030004060007120003401800
028704003093000005100200000850003000072000840000800056000007009200000560700109420
902000100068021400040309050320800090000973000070004016010608040003590260005000703
002009500080410020109500307200060940090705030014090008703004102050073090008600400
600040098280300070004108500007010640300402005042080900008706100070001029530090006
601000200037082600090605010310800050000936000020004078080209060005360490009000807
163007005024900810500010700000089160000206000078450000005040003046003270900100584
203000900017089500060205040890500010000762000030008065020907080009430250004000109
600080001020050080100907004407000608006204300203000905700805009040030050800020003
240009016930072008000030700010007840002504600085100090008040000500320084360900072
054000130000204000620080074006805700900000006003706200140020063000901000097000420
305000700074019200020307060260100070000653000010008049030205010009870430002000806
472001009081900730300060800000083960000406000056270000008090006023007510100300492
003106900078900060400050018900020074005307100640010002380060009090003420004205600
402000300081092600060401050850200090000189000090007048030506080005730420008000705
005002100030140060406900208200070690060403050073080002307006501020015080009800700
704000800098071300010308070280600040000514000050002061020407030006120490009000705
370000106048200053200130080000706590004050200017903000060098002920004810705000064
809000600057086300030504070910800050000935000060007028040109080008640290001000406
080056000130020705009100260051002046000804000370900120013008600908070054000290070
431008002062900170900050400000026390000703000075180000003060005014005230800300749
430000106056900027200360040000705410005020900012609000070081004680003270103000059
861005009079600530200040800000091720000706000054830000008060004047003950100500672
401000500067048900050302040710800030000193000030004068090401070002670350004000801
503000400021034500080501090630400010000923000070006042090705030007680150008000706
009603100067400050400010097500020063006804200310050009230080006080007540005209800
038407150000000000950000062002501300070060080009804600740000035000000000081309470
007405020104920600050000093400207056070030010520609004230000040001058902060102800
000108540650002070103900600980601407000000000204809016006004205020500038019203000
006002900080740030407100802700060410060205070095030008209004106030079080008500700
504000800016093400020801060680100050000657000050004039060905040005420910009000507
700090005020030090300708004804000601001604300902000407600803002090010060200050003
006004300080260090703800206800010960030607020054090008109006807070049050002700400
810760000002830009700002360501003080070601040080400902035200006900075200000096051
104000300059024100020709060840600030000143000010007049030405080002980750005000904
028601007093000005600800000540003000061000590000700021000004008200000150300107640
001304500089020070406000213200103007010040030900607004572000309040090860008402700
210009006000041030748200090007050208800104007901060300080002759050370000600400083
740000601052100083800460050000204310008050200019607000080096004320005970905000038
905000100076049300020503060740600090000287000080004027050301080003760540008000701
004023100210607000065040800420080603030000070506090082003070260000506049007910500
